LBRACK	[
RBRACK	]
LPAREN	(
RPAREN	)
LBRACE	{
RBRACE	}
COLON	:
ASSN	=
NE	!=
EQ	==
LT	<
LE	<=
GT	>
GE	>=
NOT	!
MINUS	-
PLUS	+
INVERT	~
AND	&
AE	&=
OR	|
OE	|=
XOR	^
XE	^=
L_AND	&&
L_OR	||
SCOPE	::
SEMI	;
TIMES	*
DIV	/
QUESTION	?
.
VOID	void
INT	int
CHAR	char
FLOAT	float
STRING	string